###################################################
      #             #         # #       #         #
# # ### ### ### # ### ######### # ####### ####### #
# #       #   # #           # # #   # #         # #
### ### ### ##### # # ####### # # ### # ##### #####
#     # # # #   # # #                     # # # # #
### ##### ### ####### # ##### # # ### # ### ### # #
#     #   # #       # #     # # #   # #     # #   #
### ### ### # ############### ### ##### ##### # ###
#                           #   #   # #     # #   #
### # # ### ##################### ### ### ### # ###
#   # #   #     #             # #       #         #
### # # ### # ### ############# ### ##### # # #####
#   # #   # #                     #   # # # #     #
# # # # ### # # ##### ### # ### ### ### ##### # ###
# # # # #   # #     # # # #   # #           # #   #
### # ##### ### # ##### ### ####### ### # # ### # #
#   # #       # #   #     #     #     # # #   # # #
### ### # # ##### ### ### ####### # ####### ##### #
#     # # #     #       #   # #   #       #   #   #
### ##### # # ### # # ####### ### # # # ### ##### #
#       # # #   # # #           # # # # # #     # #
# # # # # ### ### # # # ################# ##### # #
# # # # # #     # # # #       #   #   #       # # #
# ##### ##### ### # ### # ##### ### ### ### ### ###
#     #   #     # #   # #   # # # #   # # # # #   #
# # ######### # # # ##### ### # # # ### # ### #####
# #     # # # # # #   #               #           #
### # ### # ### # # ##### # ### # ##### ######### #
#   #         # # # #     #   # #               # #
# # # # # # # ########### # ##### ##### # # #######
# # # # # # #   #         #   #       # # #     # #
# # # ### ##### ### # # # # ##### ####### # # ### #
# # #   #     # #   # # # #     #   #   # # #     #
# # # # # # ####### ### # # # # # ### ####### # ###
# # # # # #   #       # # # # # #       # # # #   #
# # ##### ####### # ### # # # ### # # ### # ### ###
# # #       #   # #   # # # #   # # #         #   #
# ####### ### ### # ### ##### # # ########### # # #
# #             # #   # # #   # #           # # # #
######### # ######### ### ### ### # # # # #########
#         #   # # # #     #   #   # # # #         #
######### # ### # # ### # # ##### ### ### # ### # #
#   #     #           # # # #       #   # #   # # #
### ### # # # # # ######### ### # ######### ### # #
#       # # # # #       # #   # #         #   # # #
# # ### # # ### # ####### ####### # ### ### #######
# # #   # #   # #             #   #   # #       # #
### # # # # # # # ### # ######### ##### ### ##### #
#   # # # # # # #   # #       #     #     #        
###################################################
