#####################################################################################################
        #   # # # #       #         #     #                 #   #   #       # #   # # # #       #   #
# # # ##### # # # ##### ### ########### ##### # # ### # ### ### ### # ### ### # ### # # ##### ### ###
# # #   #                 #       # # #   #   # # #   # #             # # # #             #   #   # #
##### ##### # # # # ### ### ### ### # # ### # ### ### ####### # # ### # ### # ### ### # ##### ### # #
# #       # # # # # #     #   #   #       # # #     # #   #   # # #             #   # # # #         #
# ### # ####### ####### ### ### ### ### ##### ### ##### ##### ######### ##### ####### ### ### ### ###
# # # #     #     # #         #       #     #   # #       #     #   #     # #     #     #     #     #
# # ### # ##### ### ### ### ### # # ### # ### ##### ### ##### ##### ### ### ### ### # ####### ### ###
#   # # #     # #     #   # # # # # # # #   #     #   #     # # #   #   #   # #   # # # # #   #     #
### # ### # ### ### ### ##### ####### ### ### # ### ### ### ### ### ### ### # ##### ### # ### ### ###
#       # #   # #         #   # #     #     # #   #   #   # #   #   #           #           # #     #
# # ### ### ### ### ### ##### # ### ##### ### # ### ### ##### ##### ### # ### ##### # # # ####### ###
# # #         # #     # # #         #       # #       #     #   #     # # #     # # # # #   # #   # #
# ##### # # ####### ##### ### # ### ### # ### ### # ### ##### ####### ####### ### ####### ### ### # #
#   #   # # #   # # # #       # #   #   # #   # # # #     #     # #       #     # #   #         #   #
# ##### ##### ### # # ### # # # ### ### ####### ##### # ### ##### ### ####### ### ### ### # # ##### #
#   # # #       #       # # # # #           #     #   # #     #     #     #     # #     # # # #   # #
# ### ### ####### ### ######### ### # # # ##### ### # ### ##### ##### ### ### ### ##### ### ### ### #
#   #         # #   # #     # # # # # # #   # #   # #         #   #     # #     #   #         #     #
# ### ######### # ##### ##### ### ####### ### # ### # ##### ### ### ### ##### ### ##### # # ### ### #
#   #         # #   #     #   #             #     # #   # #         # # # # #   #   # # # #       # #
# ### ##### ### # ### ### ### ### # # # # ##### ##### ### ### ####### ### # # ### ### ### ### ### ###
#         # #       #   # #       # # # # #       # #       # # # #     #       # #         #   # # #
# # ### ####### ##### ####### # # ######### ### ### ### # ##### # ### ### ### ### ##### # ### ##### #
# #   #       #   #   # #     # # #   #     #         # #   #               # # #       # # # #     #
### ### # # ### ### ### ### # ##### ### ### ### ### ####### ### # ### ### ##### ### # # ### ### ### #
# #   # # #       # #       # #       # # # #     #     # #   # # #     # #         # # #         # #
# ####### ### # ### ### # # ### ######### ##### ### # ### ### ####### ##### # # # # ##### ### #######
#   #       # # #     # # #   #   #   # #   #   # # #   #   #     #     #   # # # # # #     #       #
# ##### # ########### ##### ### ### ### # ##### # ### ### ####### ### ##### ### # ### # ##### ### ###
# #   # # #   # # #           #             #       #         # # #     #     # # #     # # #   #   #
# ### ##### ### # ### # # # ### ##### ### ### ### ### ##### ### ##### ### # # ##### ### # # ##### ###
# #       # #   #   # # # # #   # # #   #   # #     #     #   #   # #   # # # #   # #       # #     #
# ### ### # ### ### ### ####### # # ##### ####### ### ##### ### ### # ### ##### ##### # ### # ### ###
#   # #                     #         # # # # #   # #   #     # #       #   #       # # #       #   #
# ##### # # # # # # # # # ### # ### ### ### # ### # ##### # ### # ####### ### ### ########### ### ###
# #     # # # # # # # # # # # # #               # #   #   # #     # # #         #     # # # #   #   #
# ### # ################### ### ### ### ### # ### # ### # ### ### # # ### # # ### # ### # # # ### # #
#   # #   #     # # #           #     #   # #   #     # #   # #         # # # #   # #           # # #
# ##### ##### ### # ### # # # # ### ### ##### ##### ### # ##### # ### ######### # ##### ### # ### # #
# #         #   # #   # # # # # #     # # #       #   # #     # # #     # #     #   # #   # # # # # #
# ### # # ### ### # ####### ####### ##### ### # ### ##### # ######### ### ##### ##### # ####### ### #
#   # # #   # #     #   #       #     #     # #       # # #     #     #     #     #       #         #
# ####### ### # ##### ##### # ##### ### ### ### ### ### ### # ####### ### ##### ##### ####### # # # #
# #         #   # #   #   # # #       # #         # #     # #     #         # #     #   #   # # # # #
# ### # # ##### # ### ### ##### ### ### ### # # ####### ##### # ##### ### ### ### ### ##### ### # ###
#   # # #     #   #             #   # # #   # # #     # #     # #     #         #       # #   # #   #
# ####### # ##### ### # # # # # ### # ##### ######### # ### # ##### # ### ### ### ### ### # ##### ###
#   #   # #   #     # # # # # # #     # #       # #       # #     # # # #   #   #   # #   #   #     #
# ##### ### ##### ##### # # ### ##### # ### ##### ### ### ### # ### ### # ### ### ####### # ##### # #
# #     #     #     # # # #   # # #       #   #     # #   #   # #   #       #   # #           # # # #
# ##### ### ##### ### ##### ##### ##### ### ##### ####### ### ######### ##### ##### # ##### ### ### #
# # #         #   #     #     #     #     # # #   # # # #       # # #     # # # #   # # #   # # #   #
# # ### # # ##### ### ##### ### ### ### ##### ### # # # ##### ### # ### ### ### ### ### ### # # ### #
#     # # # #   #       #     # # # #   # #   #           #     #     #   #         #   # #     #   #
### ##### ##### ##### ##### ##### # ### # ### ### # ### ### # ### ##### ### # ### # ### # ##### ### #
#   #       #     #   #         #   #     #   #   # #     # #   # #       # # #   # #     # #       #
### ### # ##### ##### ### # # ### ####### ### ### ##### ##### ### # ### ### ############# # ### # # #
#   # # #     #   #       # #         #   #         # #   #     #   # #   #   # # #       #   # # # #
### # ### # ### ##### # # ### # # ####### ##### # ### # ### # ##### # ##### ### # ### ### # ### #####
#         #   #     # # # #   # #     #     #   # #       # #   # #     #   #         #     # #     #
# # # # # # ### ############# ### ##### ### ### ### ### ##### ### ### ######### # # # ##### # ### ###
# # # # # # #         # #     #     # # #         # #     #         #   # #     # # # # #       #   #
# ########### ### ##### ####### # ### ##### # # ### ### ### # ### ### ### ### # ####### ##### ### ###
#     #   # #   #         # # # # #     # # # # #   #     # #   # #   #       # # #       #   # #   #
# # ##### # # ### ### ##### # ####### ### ####### # ### ### # ####### ### ### ### ##### ##### # ### #
# #   #         #   #   #   #   #   #   # #       # #     # #       #     #     #   #     #       # #
### ####### ##### ### ##### # ##### # ### ### # ### ### ##### ### ### # # # # ### ##### ####### ### #
#     # # #   # # #     #         #     #   # # # # #     #     #   # # # # # #     # #   # #     # #
# # ### # # ### ### # ##### ### ### ##### ####### ##### ### # ### ######### ### ##### # ### ### ### #
# #   #       #     # # # #   #       #       # #   #     # # #     #         #   #       # #   # # #
### ### ### ### # # ### # # ### # # ### ### ### # ##### ### ### # ####### # ### ### ### ### ### # ###
#         # #   # #   #       # # #   #   #         # #   # # # #     #   # # # #     #     #       #
### # # ##### # ### ### ### ####### ### ### ##### ### # ##### ### # ##### ### # # ##### ######### ###
# # # # # #   # #         #       # #     #     #         # # # # #     #   #       #     # # #     #
# ####### ### ##### # # ### # ####### ##### # ### # ### ### # # ### # ### ### ### ### # ### # ### ###
#   # #   # # #   # # # # # #     # #   #   #   # #   #   #       # #   #   # # #   # #   #   #     #
### # ### # ##### ####### ### # ### # ####### ##### ### ##### ####### ### ### # ##### # ### ##### ###
#                           # #   # #     # # #   # #     #       #     #         # # #     # #     #
### # # # # ### # # # ### ##### ### # ##### ### ####### ##### ####### ### ### ##### ### ##### ### ###
#   # # # # #   # # # #   #       #     #             # # #     # #     #   #     #     # # #   #   #
# # ########### # ####### ### # ##### ### ### ### ####### ### ### ### ### ##### ### # ### # # ### ###
# #   # #     # # #   #       # # #   # # #   # #   #         #         #     # #   # #         #   #
# # ### ### ####### ##### # # ### ### # ##### # ### ### # ### ### # # ##### ##### ### ### ### ### ###
# #   #   #       # # # # # # #   #       #     # #   # # #       # # #   # # #   # # # #   #   #   #
### ### ### ### ### # # ####### ####### ### ### # ### ### ### # # ####### ### ##### ### # ### ### ###
#         #   #             #   # # #   # # #       # #     # # # #     #   #   # #   #     #       #
# # # # ### ##### ### ### ##### # # ### # ####### ### ### ########### ### ### ### # ### ##### # #####
# # # # #   #   #   #   #     #     # #     # # #   # #             #       #   #     #   #   #   # #
# ### ##### # ### ### ##### ### ### # # ##### # # ####### ### # # ### ### ### ### ##### ##### # ### #
# #       #   # # #       #   # #         #         #       # # #   #   # #                 # #     #
##### ##### ### ### # # ### ####### ### ##### ##### ### # ####### ### ####### ### # # ### ##### ### #
#         #   #   # # #   #   # # #   # # #   # # # # # # # #       #   # #     # # #   #   #     # #
# # # ##### ### ### ### ### ### # # ##### ### # # ### ##### ### # ### ### ### ####### ### ##### ### #
# # # #       #   #   # #     #       #           #             # # #       #   #   # #     # # #   #
# ##### ### ### ##### ##### ### ### ##### # # ### ### ####### # ### # ### ### ##### ### # ### ### # #
#   #     #         #   #     #   # #   # # # #       # #   # #         #   #   #       # # # # # # #
# ### ##### # # # ### ##### ### ####### ### ##### # ### ### ### ##### ### ### ### # ### ### # # ### #
#       #   # # # #       #       #         #     # #               # #         # # #           #    
#####################################################################################################
